11111111111
1P000000001
101111111101
10C000000C01
111110111101
100010001E01
101011101001
10C0000C0001
11111111111