1111111111111
1P00000000C01
1011111111011
1P0000000C0E1
1011111011111
1000000010001
1C00010000E01
1111111111111