111111111111111
1P0000000000001
101111111111101
100000000000001
101111111111101
100000000000001
101111111111101
10000000000C001
111111111101111
1C00000000000E1
111111111111111