111111111111111111111
1P0000000000000000001
111111111111111111101
100000000000000000001
101111111111111111101
100000000000000000001
101111111111111111101
100000000000000000001
101111111111111111101
100000000000000000E01
111111111111111111111