111111111111
100000000000
101001010010
101001001010
100000000000
101001010010
101001001010
100000000000
101001010010
101001001010
100000000000
111111111111