111111111111111111111
1000000000000000000P1
10C000C000C0001101101
100000000000000000011
10C000C000C0001101101
10C000C000C0001101101
100000000000E01101101
100000000000001101101
111111111111111111111