11111
1E001
10101
10101
1P001
11111