111111111111111
1P0000000000001
101111111111101
101000000C00001
101011111111101
100010000000C01
111011101111111
1C0001000000001
101111101111101
100000001000E01
111111111111111