1111111111111
1P00000000C01
1011111111011
10C000000C001
1011111011111
1000000010001
1111101110111
1C00010000E01
1111111111111